#Scenario,#States,#Transition,TranslationTime,SolvingTime,TotalTime 
2,10,18,192,20,212
2,11,20,195,30,225
2,12,22,141,45,186
2,13,24,143,110,253
2,14,26,157,135,292
2,15,28,158,430,588
2,16,30,170,340,510
2,17,32,194,565,759
2,18,34,190,990,1180
2,19,36,201,2000,2201
2,20,38,195,6970,7165